NO textures/tuff.xpm
SO textures/polished_blackstone_bricks_0.xpm
WE textures/black_terracotta.xpm
EA textures/dragon_egg.xpm

F 220,100,0
C 225,30,0

1111111111111111111111111
1000000000110000000000001
10110000011100000P0N00001
10010000000000000000000011111
11111111 1111111 111111111111